华北地区
北京市（16个）	东城区、西城区、海淀区、朝阳区、丰台区、石景山区、通州区、顺义区、房山区、大兴区、昌平区、怀柔区、平谷区、门头沟区、延庆区、密云区
天津市（16个）	和平区、河东区、河西区、南开区、河北区、红桥区、滨海新区、东丽区、西青区、津南区、北辰区、武清区、宝坻区、宁河区、静海区、蓟州区
河北省（47个）	石家庄市	长安区、桥西区、新华区、井陉矿区、裕华区、栾城区、藁城区、鹿泉区
唐山市	路南区、路北区、古冶区、开平区、丰南区、丰润区、曹妃甸区
秦皇岛市	海港区、山海关区、北戴河区、抚宁区
邯郸市	丛台区、邯山区、复兴区、峰峰矿区、肥乡区、永年区
邢台市	桥东区、桥西区
保定市	竞秀区、莲池区、满城区、清苑区、徐水区
张家口市	桥东区、桥西区、下花园区、宣化区、万全区、崇礼区
承德市	双桥区、双滦区、鹰手营子矿区
沧州市	运河区、新华区
廊坊市	安次区、广阳区
衡水市	桃城区、冀州区
山西省（25个）太原市	杏花岭区、小店区、迎泽区、尖草坪区、万柏林区、晋源区
大同市	平城区、云州区、云冈区、新荣区 [9] 
阳泉市	城区、矿区、郊区
长治市	潞州区、上党区、屯留区、潞城区
晋城市	城区
朔州市	朔城区、平鲁区
忻州市	忻府区
吕梁市	离石区
晋中市	榆次区
临汾市	尧都区
运城市	盐湖区
内蒙古自治区（23个）呼和浩特市	回民区、新城区、玉泉区、赛罕区
包头市	昆都仑区、东河区、青山区、石拐区、九原区、白云鄂博矿区
乌海市	海勃湾区、海南区、乌达区
赤峰市	红山区、元宝山区、松山区
呼伦贝尔市	海拉尔区、扎赉诺尔区
通辽市	科尔沁区
乌兰察布市	集宁区
鄂尔多斯市	东胜区、康巴什区
巴彦淖尔市
	临河区
东北地区
辽宁省（59个）沈阳市	沈河区、皇姑区、和平区、大东区、铁西区、苏家屯区、浑南区、于洪区、辽中区、沈北新区
大连市	西岗区、中山区、沙河口区、甘井子区、旅顺口区、金州区、普兰店区
鞍山市	铁东区、铁西区、立山区、千山区
抚顺市	顺城区、新抚区、东洲区、望花区
本溪市	平山区、明山区、溪湖区、南芬区
丹东市	振兴区、元宝区、振安区
锦州市	太和区、古塔区、凌河区
营口市	站前区、西市区、鲅鱼圈区、老边区
阜新市	海州区、新邱区、太平区、清河门区、细河区
辽阳市	白塔区、文圣区、宏伟区、太子河区、弓长岭区
盘锦市	双台子区、兴隆台区、大洼区
铁岭市	银州区、清河区
朝阳市	双塔区、龙城区
葫芦岛市	龙港区、南票区、连山区
吉林省（21个）长春市	朝阳区、南关区、宽城区、二道区、绿园区、双阳区、九台区
吉林市	船营区、昌邑区、龙潭区、丰满区
四平市	铁西区、铁东区
辽源市	龙山区、西安区
通化市	东昌区、二道江区
白山市	浑江区、江源区
白城市	洮北区
松原市	宁江区
黑龙江省（65个）哈尔滨市	道里区、南岗区、道外区、香坊区、松北区、平房区、呼兰区、阿城区、双城区
齐齐哈尔市	龙沙区、建华区、铁锋区、富拉尔基区、昂昂溪区、碾子山区、梅里斯达斡尔族区
牡丹江市	爱民区、东安区、阳明区、西安区
佳木斯市	前进区、向阳区、东风区、郊区
大庆市	萨尔图区、龙凤区、让胡路区、红岗区、大同区
伊春市	伊春区、南岔区、友好区、西林区、翠峦区、新青区、美溪区、金山屯区、五营区、乌马河区、汤旺河区、带岭区、乌伊岭区、红星区、上甘岭区
鸡西市	鸡冠区、恒山区、滴道区、梨树区、城子河区、麻山区
鹤岗市	兴山区、向阳区、工农区、南山区、兴安区、东山区
双鸭山市	尖山区、岭东区、四方台区、宝山区
七台河市	桃山区、新兴区、茄子河区
绥化市	北林区
黑河市	爱辉区
华东地区
上海市（16个）	黄浦区、徐汇区、长宁区、静安区、普陀区、虹口区、杨浦区、宝山区、闵行区、嘉定区、松江区、青浦区、奉贤区、金山区、浦东新区、崇明区
江苏省（55个）南京市	玄武区、秦淮区、建邺区、鼓楼区、浦口区、栖霞区、雨花台区、江宁区、六合区、溧水区、高淳区
无锡市	锡山区、惠山区、滨湖区、梁溪区、新吴区
徐州市	鼓楼区、云龙区、贾汪区、泉山区、铜山区
常州市	天宁区、钟楼区、新北区、武进区、金坛区
苏州市	姑苏区、虎丘区、吴中区、相城区、吴江区
南通市	崇川区、港闸区、通州区
连云港市	连云区、海州区、赣榆区
淮安市	清江浦区、淮安区、淮阴区、洪泽区
盐城市	亭湖区、盐都区、大丰区
扬州市	广陵区、邗江区、江都区
镇江市	京口区、润州区、丹徒区
泰州市	海陵区、高港区、姜堰区
宿迁市	宿城区、宿豫区
浙江省（37个）杭州市	拱墅区、上城区、下城区、江干区、西湖区、滨江区、萧山区、余杭区、富阳区、临安区
宁波市	海曙区、江北区、北仑区、镇海区、鄞州区、奉化区
温州市	鹿城区、龙湾区、瓯海区、洞头区
绍兴市	越城区、柯桥区、上虞区
湖州市	吴兴区、南浔区
嘉兴市	南湖区、秀洲区
金华市	婺城区、金东区
衢州市	柯城区、衢江区
台州市	椒江区、黄岩区、路桥区
丽水市	莲都区
舟山市	定海区、普陀区
安徽省（44个）合肥市	瑶海区、庐阳区、蜀山区、包河区
芜湖市	镜湖区、弋江区、三山区、鸠江区
蚌埠市	蚌山区、禹会区、龙子湖区、淮上区
淮南市	田家庵区、大通区、谢家集区、八公山区、潘集区
马鞍山市	雨山区、花山区、博望区
淮北市	相山区、杜集区、烈山区
铜陵市	铜官区、郊区、义安区
安庆市	迎江区、大观区、宜秀区
黄山市	屯溪区、黄山区、徽州区
阜阳市	颍州区、颍东区、颍泉区
宿州市	埇桥区
滁州市	琅琊区、南谯区
六安市	金安区、裕安区、叶集区
宣城市	宣州区
池州市	贵池区
亳州市	谯城区
福建省（29个）福州市	鼓楼区、台江区、仓山区、马尾区、晋安区、长乐区
莆田市	城厢区、涵江区、荔城区、秀屿区
泉州市	鲤城区、丰泽区、洛江区、泉港区
厦门市	思明区、湖里区、海沧区、集美区、同安区、翔安区
漳州市	芗城区、龙文区
龙岩市	新罗区、永定区
三明市	梅列区、三元区
南平市	延平区、建阳区
宁德市	蕉城区
江西省（26个）南昌市	东湖区、西湖区、青云谱区、湾里区、青山湖区、新建区
赣州市	章贡区、南康区、赣县区
宜春市	袁州区
吉安市	吉州区、青原区
上饶市	信州区、广丰区
抚州市	临川区、东乡区
九江市	浔阳区、濂溪区、柴桑区
景德镇市	昌江区、珠山区
萍乡市	安源区、湘东区
新余市	渝水区
鹰潭市	月湖区、余江区
山东省（54个）济南市	历下区、市中区、槐荫区、天桥区、历城区、长清区、章丘区、莱芜区、钢城区
青岛市	市南区、市北区、李沧区、崂山区、城阳区、黄岛区、即墨区
淄博市	张店区、临淄区、淄川区、博山区、周村区
枣庄市	薛城区、市中区、峄城区、山亭区、台儿庄区
东营市	东营区、河口区、垦利区
烟台市	莱山区、芝罘区、福山区、牟平区
潍坊市	奎文区、潍城区、寒亭区、坊子区
济宁市	任城区、兖州区
泰安市	泰山区、岱岳区
威海市	环翠区、文登区
日照市	东港区、岚山区
滨州市	滨城区、沾化区
德州市	德城区、陵城区
聊城市	东昌府区
临沂市	兰山区、罗庄区、河东区
菏泽市	牡丹区、定陶区
华中地区
河南省（52个）郑州市	中原区、金水区、二七区、管城区、惠济区、上街区
开封市	鼓楼区、龙亭区、顺河区、禹王台区、祥符区
洛阳市	涧西区、西工区、洛龙区、老城区、瀍河区、吉利区
平顶山市	新华区、卫东区、湛河区、石龙区
安阳市	殷都区、文峰区、龙安区、北关区
鹤壁市	淇滨区、山城区、鹤山区
新乡市	卫滨区、红旗区、凤泉区、牧野区
焦作市	解放区、中站区、马村区、山阳区
濮阳市	华龙区
许昌市	魏都区、建安区
漯河市	源汇区、郾城区、召陵区
三门峡市	湖滨区、陕州区
南阳市	卧龙区、宛城区
商丘市	睢阳区、梁园区
信阳市	平桥区、浉河区
周口市	川汇区
驻马店市	驿城区
湖北省（39个）武汉市	江岸区、江汉区、硚口区、汉阳区、武昌区、青山区、洪山区、东西湖区、汉南区、蔡甸区、江夏区、黄陂区、新洲区
黄石市	黄石港区、西塞山区、下陆区、铁山区
十堰市	茅箭区、张湾区、郧阳区
荆州市	沙市区、荆州区
宜昌市	西陵区、伍家岗区、点军区、猇亭区、夷陵区
襄阳市	襄城区、樊城区、襄州区
鄂州市	鄂城区、梁子湖区、华容区
荆门市	东宝区、掇刀区
黄冈市	黄州区
孝感市	孝南区
咸宁市	咸安区
随州市	曾都区
湖南省（35个）长沙市	岳麓区、芙蓉区、天心区、开福区、雨花区、望城区
株洲市	天元区、荷塘区、芦淞区、石峰区、渌口区 [10] 
湘潭市	岳塘区、雨湖区
衡阳市	雁峰区、珠晖区、石鼓区、蒸湘区、南岳区
邵阳市	双清区、大祥区、北塔区
岳阳市	岳阳楼区、君山区、云溪区
张家界市	永定区、武陵源区
益阳市	赫山区、资阳区
常德市	鼎城区、武陵区
娄底市	娄星区
郴州市	苏仙区、北湖区
永州市	零陵区、冷水滩区
怀化市	鹤城区
华南地区
广东省（65个）广州市	越秀区、天河区、荔湾区、海珠区、白云区、黄埔区、花都区、番禺区、南沙区、从化区、增城区
深圳市	福田区、罗湖区、南山区、盐田区、宝安区、龙岗区、龙华区、坪山区、光明区
珠海市	香洲区、斗门区、金湾区
汕头市	龙湖区、金平区、濠江区、澄海区、潮阳区、潮南区
佛山市	禅城区、南海区、顺德区、高明区、三水区
韶关市	浈江区、武江区、曲江区
湛江市	赤坎区、霞山区、坡头区、麻章区
肇庆市	端州区、鼎湖区、高要区
江门市	蓬江区、江海区、新会区
茂名市	茂南区、电白区
惠州市	惠城区、惠阳区
梅州市	梅江区、梅县区
汕尾市	城区
河源市	源城区
阳江市	江城区、阳东区
清远市	清城区、清新区
潮州市	湘桥区、潮安区
揭阳市	榕城区、揭东区
云浮市	云城区、云安区
广西壮族自治区（40个）南宁市	青秀区、兴宁区、西乡塘区、江南区、良庆区、邕宁区、武鸣区
柳州市	城中区、鱼峰区、柳北区、柳南区、柳江区
桂林市	象山区、秀峰区、叠彩区、七星区、雁山区、临桂区
梧州市	万秀区、龙圩区、长洲区
北海市	海城区、银海区、铁山港区
崇左市	江州区
来宾市	兴宾区
贺州市	八步区、平桂区
玉林市	玉州区、福绵区
百色市	右江区
河池市	金城江区、宜州区
钦州市	钦南区、钦北区
防城港市	港口区、防城区
贵港市	港北区、港南区、覃塘区
海南省（8个）海口市	秀英区、龙华区、琼山区、美兰区
三亚市	天涯区、吉阳区、海棠区、崖州区
西北地区
陕西省（30个）西安市	新城区、碑林区、莲湖区、灞桥区、未央区、雁塔区、阎良区、临潼区、长安区、高陵区、鄠邑区
铜川市	耀州区、王益区、印台区
宝鸡市	渭滨区、金台区、陈仓区
咸阳市	秦都区、渭城区、杨陵区
渭南市	临渭区、华州区
汉中市	汉台区、南郑区 [11] 
安康市	汉滨区
商洛市	商州区
延安市	宝塔区、安塞区
榆林市	榆阳区、横山区
甘肃省（17个）兰州市	城关区、七里河区、西固区、安宁区、红古区
金昌市	金川区
白银市	白银区、平川区
天水市	秦州区、麦积区
酒泉市	肃州区
张掖市	甘州区
武威市	凉州区
定西市	安定区
陇南市	武都区
平凉市	崆峒区
庆阳市	西峰区
青海省（6个）西宁市	城东区、城中区、城西区、城北区
海东市	乐都区、平安区
宁夏回族自治区（9个）银川市	兴庆区、金凤区、西夏区
石嘴山市	大武口区、惠农区
吴忠市	利通区、红寺堡区
固原市	原州区
中卫市	沙坡头区
新疆维吾尔自治区（13个）乌鲁木齐市	天山区、沙依巴克区、新市区、水磨沟区、头屯河区、达坂城区、米东区
克拉玛依市	独山子区、克拉玛依区、白碱滩区、乌尔禾区
吐鲁番市	高昌区
哈密市	伊州区
西南地区
重庆市（26个）	万州区、涪陵区、渝中区、江北区、沙坪坝区、南岸区、大渡口区、九龙坡区、北碚区、渝北区、巴南区、黔江区、长寿区、合川区、南川区、江津区、永川区、大足区、綦江区、璧山区、铜梁区、潼南区、荣昌区、开州区、梁平区、武隆区
四川省（54个）	成都市	成华区、武侯区、青羊区、锦江区、金牛区、龙泉驿区、青白江区、新都区、温江区、双流区、郫都区 [12] 
绵阳市	涪城区、游仙区、安州区
自贡市	自流井区、贡井区、大安区、沿滩区
攀枝花市	东区、西区、仁和区
泸州市	江阳区、纳溪区、龙马潭区
德阳市	旌阳区、罗江区 [12] 
广元市	利州区、昭化区、朝天区
遂宁市	船山区、安居区
内江市	市中区、东兴区
乐山市	市中区、五通桥区、沙湾区、金口河区
资阳市	雁江区
宜宾市	翠屏区、南溪区、叙州区 [12] 
南充市	顺庆区、高坪区、嘉陵区
达州市	通川区、达川区
雅安市	雨城区、名山区
广安市	广安区、前锋区
巴中市	巴州区、恩阳区
眉山市	东坡区、彭山区
贵州省（18个）贵阳市	云岩区、南明区、小河区（经开区）、花溪区、乌当区、白云区、观山湖区
六盘水市	钟山区
遵义市	红花岗区、汇川区、播州区、新蒲新区
铜仁市	碧江区、万山区
毕节市	七星关区、金海湖区
安顺市	西秀区、平坝区
云南省（16个）昆明市	盘龙区、五华区、官渡区、西山区、东川区、呈贡区、晋宁区
昭通市	昭阳区
曲靖市	麒麟区、沾益区
玉溪市	红塔区、江川区
普洱市	思茅区
保山市	隆阳区
丽江市	古城区
临沧市	临翔区
西藏自治区（6个）拉萨市	城关区、堆龙德庆区
昌都市	卡若区
山南市	乃东区
日喀则市	桑珠孜区
林芝市	巴宜区
港澳地区
香港特别行政区（18个）	中西区、湾仔区、东区、南区、油尖旺区、深水埗区、九龙城区、黄大仙区、观塘区、北区、大埔区、沙田区、西贡区、荃湾区、屯门区、元朗区、葵青区、离岛区
澳门特别行政区（7个）	花地玛堂区、圣安多尼堂区、大堂区、望德堂区、风顺堂区、嘉模堂区、圣方济各堂区
